wwwwwwwwwwwwwwwwww
w.......A........w
w..........w.....w
w................w
w................w
w................w
w................w
w.........w......w
w....3.........w.w
w.g.+............w
w................w
wwwwwwwwwwwwwwwwww