wwwwwwwwwwwwwwwwww
w................w
w.1..............w
w..+.....1..w....w
w...w..g....w.+..w
w................w
w................w
w.w..gA...w......w
w.......w.w......w
w..A.............w
w................w
wwwwwwwwwwwwwwwwww
